敌空空空敌空空空空敌
空砖空砖空砖空空砖空
空铁空铁空铁空空铁空
空砖空砖空砖空空砖空
空铁空铁空铁空空铁空
空空空空空空空空空空
铁水空空铁空空水空铁
草砖砖草砖草砖砖空草
空空空空空空空空空空
空空空空空空空空空空